"filename", "language", "Python", "YAML", "Markdown", "pip requirements", "comment", "blank", "total"
"/home/wenzihao/Desktop/WandCalibration/README.md", "Markdown", 0, 0, 38, 0, 0, 3, 41
"/home/wenzihao/Desktop/WandCalibration/blender/test.py", "Python", 12, 0, 0, 0, 1, 10, 23
"/home/wenzihao/Desktop/WandCalibration/config/board/board_sample.yaml", "YAML", 0, 3, 0, 0, 14, 4, 21
"/home/wenzihao/Desktop/WandCalibration/config/board/charucoboard_4_5.yaml", "YAML", 0, 5, 0, 0, 10, 3, 18
"/home/wenzihao/Desktop/WandCalibration/config/board/checkerboard_11_8.yaml", "YAML", 0, 4, 0, 0, 12, 2, 18
"/home/wenzihao/Desktop/WandCalibration/config/cfg_archery.yaml", "YAML", 0, 25, 0, 0, 11, 13, 49
"/home/wenzihao/Desktop/WandCalibration/config/cfg_archery_outdoor.yaml", "YAML", 0, 25, 0, 0, 11, 13, 49
"/home/wenzihao/Desktop/WandCalibration/config/cfg_uni.yaml", "YAML", 0, 39, 0, 0, 34, 9, 82
"/home/wenzihao/Desktop/WandCalibration/config/cfg_wtt.yaml", "YAML", 0, 26, 0, 0, 11, 8, 45
"/home/wenzihao/Desktop/WandCalibration/config/cfg_wtt_red.yaml", "YAML", 0, 25, 0, 0, 11, 7, 43
"/home/wenzihao/Desktop/WandCalibration/config/config.yaml", "YAML", 0, 17, 0, 0, 10, 13, 40
"/home/wenzihao/Desktop/WandCalibration/config/labelme/labelme_sample.yaml", "YAML", 0, 6, 0, 0, 2, 0, 8
"/home/wenzihao/Desktop/WandCalibration/config/point/point_sample.yaml", "YAML", 0, 6, 0, 0, 2, 0, 8
"/home/wenzihao/Desktop/WandCalibration/config/point/point_wtt.yaml", "YAML", 0, 6, 0, 0, 1, 0, 7
"/home/wenzihao/Desktop/WandCalibration/config/pole/pole500.yaml", "YAML", 0, 4, 0, 0, 0, 0, 4
"/home/wenzihao/Desktop/WandCalibration/config/pole/pole760.yaml", "YAML", 0, 4, 0, 0, 0, 0, 4
"/home/wenzihao/Desktop/WandCalibration/config/pole/pole760_red.yaml", "YAML", 0, 4, 0, 0, 0, 0, 4
"/home/wenzihao/Desktop/WandCalibration/config/pole/pole_sample.yaml", "YAML", 0, 3, 0, 0, 7, 2, 12
"/home/wenzihao/Desktop/WandCalibration/config/wand/wand750.yaml", "YAML", 0, 10, 0, 0, 8, 1, 19
"/home/wenzihao/Desktop/WandCalibration/config/wand/wand_archery.yaml", "YAML", 0, 10, 0, 0, 4, 1, 15
"/home/wenzihao/Desktop/WandCalibration/config/wand/wand_sample.yaml", "YAML", 0, 9, 0, 0, 7, 1, 17
"/home/wenzihao/Desktop/WandCalibration/config/wand/wand_wtt.yaml", "YAML", 0, 10, 0, 0, 4, 1, 15
"/home/wenzihao/Desktop/WandCalibration/config/wand/wand_wtt_red.yaml", "YAML", 0, 10, 0, 0, 8, 4, 22
"/home/wenzihao/Desktop/WandCalibration/extrinsicParameter/__init__.py", "Python", 0, 0, 0, 0, 0, 1, 1
"/home/wenzihao/Desktop/WandCalibration/extrinsicParameter/initPose/initPose.py", "Python", 65, 0, 0, 0, 3, 7, 75
"/home/wenzihao/Desktop/WandCalibration/extrinsicParameter/initPose/integratePose.py", "Python", 50, 0, 0, 0, 3, 4, 57
"/home/wenzihao/Desktop/WandCalibration/extrinsicParameter/initPose/mst.py", "Python", 55, 0, 0, 0, 1, 8, 64
"/home/wenzihao/Desktop/WandCalibration/extrinsicParameter/initPose/recoverPose.py", "Python", 78, 0, 0, 0, 5, 8, 91
"/home/wenzihao/Desktop/WandCalibration/extrinsicParameter/poleDetection/__init__.py", "Python", 0, 0, 0, 0, 0, 1, 1
"/home/wenzihao/Desktop/WandCalibration/extrinsicParameter/poleDetection/blobDetection.py", "Python", 166, 0, 0, 0, 21, 11, 198
"/home/wenzihao/Desktop/WandCalibration/extrinsicParameter/poleDetection/maskGeneration.py", "Python", 122, 0, 0, 0, 15, 10, 147
"/home/wenzihao/Desktop/WandCalibration/extrinsicParameter/poleDetection/poleDetection.py", "Python", 193, 0, 0, 0, 10, 11, 214
"/home/wenzihao/Desktop/WandCalibration/extrinsicParameter/poleDetection/wandDetection.py", "Python", 194, 0, 0, 0, 9, 11, 214
"/home/wenzihao/Desktop/WandCalibration/extrinsicParameter/refinePose/boundleAdjustment.py", "Python", 258, 0, 0, 0, 26, 19, 303
"/home/wenzihao/Desktop/WandCalibration/extrinsicParameter/refinePose/multiViewTriangulate.py", "Python", 194, 0, 0, 0, 16, 11, 221
"/home/wenzihao/Desktop/WandCalibration/extrinsicParameter/refinePose/normalizedImagePlane.py", "Python", 50, 0, 0, 0, 6, 6, 62
"/home/wenzihao/Desktop/WandCalibration/extrinsicParameter/refinePose/refinePose.py", "Python", 251, 0, 0, 0, 17, 15, 283
"/home/wenzihao/Desktop/WandCalibration/extrinsicParameter/refinePose/rotation_conversions.py", "Python", 412, 0, 0, 0, 24, 98, 534
"/home/wenzihao/Desktop/WandCalibration/extrinsicParameter/refinePose/so3_exp_map.py", "Python", 68, 0, 0, 0, 1, 22, 91
"/home/wenzihao/Desktop/WandCalibration/extrinsicParameter/worldCoord/adjustCamParam.py", "Python", 65, 0, 0, 0, 0, 3, 68
"/home/wenzihao/Desktop/WandCalibration/extrinsicParameter/worldCoord/clickPoint.py", "Python", 98, 0, 0, 0, 27, 10, 135
"/home/wenzihao/Desktop/WandCalibration/extrinsicParameter/worldCoord/cluster.py", "Python", 40, 0, 0, 0, 4, 5, 49
"/home/wenzihao/Desktop/WandCalibration/extrinsicParameter/worldCoord/get_cam0_extrinsic.py", "Python", 215, 0, 0, 0, 16, 9, 240
"/home/wenzihao/Desktop/WandCalibration/extrinsicParameter/worldCoord/get_id_with_distance.py", "Python", 62, 0, 0, 0, 0, 8, 70
"/home/wenzihao/Desktop/WandCalibration/extrinsicParameter/worldCoord/handle_board.py", "Python", 106, 0, 0, 0, 3, 5, 114
"/home/wenzihao/Desktop/WandCalibration/extrinsicParameter/worldCoord/handle_labelme.py", "Python", 133, 0, 0, 0, 1, 9, 143
"/home/wenzihao/Desktop/WandCalibration/extrinsicParameter/worldCoord/icp.py", "Python", 78, 0, 0, 0, 16, 28, 122
"/home/wenzihao/Desktop/WandCalibration/extrinsicParameter/worldCoord/noIdReconstruction.py", "Python", 182, 0, 0, 0, 25, 15, 222
"/home/wenzihao/Desktop/WandCalibration/extrinsicParameter/worldCoord/solve_icp.py", "Python", 21, 0, 0, 0, 2, 3, 26
"/home/wenzihao/Desktop/WandCalibration/intrinsicParameter/__init__.py", "Python", 0, 0, 0, 0, 0, 1, 1
"/home/wenzihao/Desktop/WandCalibration/intrinsicParameter/charucoboardCalibration/get_cam_calibration.py", "Python", 115, 0, 0, 0, 12, 6, 133
"/home/wenzihao/Desktop/WandCalibration/intrinsicParameter/charucoboardCalibration/test_cam_calibration.py", "Python", 44, 0, 0, 0, 1, 8, 53
"/home/wenzihao/Desktop/WandCalibration/intrinsicParameter/checkerboardCalibration/get_cam_calibration.py", "Python", 91, 0, 0, 0, 9, 5, 105
"/home/wenzihao/Desktop/WandCalibration/intrinsicParameter/checkerboardCalibration/test_cam_calibration.py", "Python", 49, 0, 0, 0, 14, 18, 81
"/home/wenzihao/Desktop/WandCalibration/intrinsicParameter/intrinsicCalibration/get_intrinsic.py", "Python", 66, 0, 0, 0, 10, 6, 82
"/home/wenzihao/Desktop/WandCalibration/main.py", "Python", 185, 0, 0, 0, 2, 7, 194
"/home/wenzihao/Desktop/WandCalibration/pyinstaller.md", "Markdown", 0, 0, 6, 0, 0, 1, 7
"/home/wenzihao/Desktop/WandCalibration/requirements.txt", "pip requirements", 0, 0, 0, 12, 0, 1, 13
"/home/wenzihao/Desktop/WandCalibration/utils/__init__.py", "Python", 0, 0, 0, 0, 0, 1, 1
"/home/wenzihao/Desktop/WandCalibration/utils/imageConcat.py", "Python", 36, 0, 0, 0, 3, 2, 41
"/home/wenzihao/Desktop/WandCalibration/utils/verifyAccuracy.py", "Python", 52, 0, 0, 0, 0, 6, 58
"/home/wenzihao/Desktop/WandCalibration/utils/yamlLoader.py", "Python", 58, 0, 0, 0, 8, 14, 80
"/home/wenzihao/Desktop/WandCalibration/visualize/get_init_camera_params.py", "Python", 17, 0, 0, 0, 0, 3, 20
"/home/wenzihao/Desktop/WandCalibration/visualize/visCameraParams.py", "Python", 48, 0, 0, 0, 3, 3, 54
"/home/wenzihao/Desktop/WandCalibration/visualize/vis_pole_detection.py", "Python", 67, 0, 0, 0, 1, 8, 76
"/home/wenzihao/Desktop/WandCalibration/visualize/vis_pole_spread.py", "Python", 64, 0, 0, 0, 0, 6, 70
"/home/wenzihao/Desktop/WandCalibration/visualize/vis_reproj_error.py", "Python", 107, 0, 0, 0, 2, 11, 120
"Total", "-", 4167, 251, 44, 12, 484, 540, 5498