"filename", "language", "YAML", "Python", "Markdown", "comment", "blank", "total"
"/home/wenzihao/Desktop/WandCalibration/README.md", "Markdown", 0, 0, 2, 0, 1, 3
"/home/wenzihao/Desktop/WandCalibration/config/board/board_sample.yaml", "YAML", 3, 0, 0, 14, 4, 21
"/home/wenzihao/Desktop/WandCalibration/config/board/charucoboard_4_5.yaml", "YAML", 5, 0, 0, 10, 3, 18
"/home/wenzihao/Desktop/WandCalibration/config/board/checkerboard_11_8.yaml", "YAML", 3, 0, 0, 12, 3, 18
"/home/wenzihao/Desktop/WandCalibration/config/cfg_archery.yaml", "YAML", 25, 0, 0, 11, 13, 49
"/home/wenzihao/Desktop/WandCalibration/config/cfg_wtt.yaml", "YAML", 25, 0, 0, 11, 7, 43
"/home/wenzihao/Desktop/WandCalibration/config/config.yaml", "YAML", 17, 0, 0, 10, 13, 40
"/home/wenzihao/Desktop/WandCalibration/config/point/point_sample.yaml", "YAML", 6, 0, 0, 2, 0, 8
"/home/wenzihao/Desktop/WandCalibration/config/point/point_wtt.yaml", "YAML", 6, 0, 0, 1, 0, 7
"/home/wenzihao/Desktop/WandCalibration/config/pole/pole500.yaml", "YAML", 4, 0, 0, 0, 0, 4
"/home/wenzihao/Desktop/WandCalibration/config/pole/pole760.yaml", "YAML", 4, 0, 0, 0, 0, 4
"/home/wenzihao/Desktop/WandCalibration/config/pole/pole_sample.yaml", "YAML", 3, 0, 0, 7, 2, 12
"/home/wenzihao/Desktop/WandCalibration/config/wand/wand750.yaml", "YAML", 10, 0, 0, 8, 1, 19
"/home/wenzihao/Desktop/WandCalibration/config/wand/wand_archery.yaml", "YAML", 10, 0, 0, 4, 1, 15
"/home/wenzihao/Desktop/WandCalibration/config/wand/wand_sample.yaml", "YAML", 9, 0, 0, 7, 1, 17
"/home/wenzihao/Desktop/WandCalibration/config/wand/wand_wtt.yaml", "YAML", 10, 0, 0, 4, 1, 15
"/home/wenzihao/Desktop/WandCalibration/extrinsicParameter/__init__.py", "Python", 0, 0, 0, 0, 1, 1
"/home/wenzihao/Desktop/WandCalibration/extrinsicParameter/initPose/initPose.py", "Python", 0, 65, 0, 3, 7, 75
"/home/wenzihao/Desktop/WandCalibration/extrinsicParameter/initPose/integratePose.py", "Python", 0, 50, 0, 3, 4, 57
"/home/wenzihao/Desktop/WandCalibration/extrinsicParameter/initPose/mst.py", "Python", 0, 55, 0, 1, 8, 64
"/home/wenzihao/Desktop/WandCalibration/extrinsicParameter/initPose/recoverPose.py", "Python", 0, 78, 0, 5, 8, 91
"/home/wenzihao/Desktop/WandCalibration/extrinsicParameter/poleDetection/__init__.py", "Python", 0, 0, 0, 0, 1, 1
"/home/wenzihao/Desktop/WandCalibration/extrinsicParameter/poleDetection/blobDetection.py", "Python", 0, 164, 0, 20, 11, 195
"/home/wenzihao/Desktop/WandCalibration/extrinsicParameter/poleDetection/maskGeneration.py", "Python", 0, 110, 0, 15, 10, 135
"/home/wenzihao/Desktop/WandCalibration/extrinsicParameter/poleDetection/poleDetection.py", "Python", 0, 193, 0, 10, 11, 214
"/home/wenzihao/Desktop/WandCalibration/extrinsicParameter/poleDetection/wandDetection.py", "Python", 0, 145, 0, 7, 7, 159
"/home/wenzihao/Desktop/WandCalibration/extrinsicParameter/refinePose/boundleAdjustment.py", "Python", 0, 197, 0, 55, 14, 266
"/home/wenzihao/Desktop/WandCalibration/extrinsicParameter/refinePose/multiViewTriangulate.py", "Python", 0, 175, 0, 15, 10, 200
"/home/wenzihao/Desktop/WandCalibration/extrinsicParameter/refinePose/normalizedImagePlane.py", "Python", 0, 50, 0, 6, 6, 62
"/home/wenzihao/Desktop/WandCalibration/extrinsicParameter/refinePose/refinePose.py", "Python", 0, 73, 0, 11, 6, 90
"/home/wenzihao/Desktop/WandCalibration/extrinsicParameter/worldCoord/adjustCamParam.py", "Python", 0, 30, 0, 0, 3, 33
"/home/wenzihao/Desktop/WandCalibration/extrinsicParameter/worldCoord/clickPoint.py", "Python", 0, 98, 0, 27, 10, 135
"/home/wenzihao/Desktop/WandCalibration/extrinsicParameter/worldCoord/get_cam0_extrinsic.py", "Python", 0, 61, 0, 11, 6, 78
"/home/wenzihao/Desktop/WandCalibration/extrinsicParameter/worldCoord/get_id_with_distance.py", "Python", 0, 44, 0, 0, 7, 51
"/home/wenzihao/Desktop/WandCalibration/extrinsicParameter/worldCoord/icp.py", "Python", 0, 78, 0, 16, 28, 122
"/home/wenzihao/Desktop/WandCalibration/extrinsicParameter/worldCoord/noIdReconstruction.py", "Python", 0, 174, 0, 15, 15, 204
"/home/wenzihao/Desktop/WandCalibration/extrinsicParameter/worldCoord/solve_icp.py", "Python", 0, 18, 0, 2, 3, 23
"/home/wenzihao/Desktop/WandCalibration/intrinsicParameter/__init__.py", "Python", 0, 0, 0, 0, 1, 1
"/home/wenzihao/Desktop/WandCalibration/intrinsicParameter/charucoboardCalibration/get_cam_calibration.py", "Python", 0, 63, 0, 10, 5, 78
"/home/wenzihao/Desktop/WandCalibration/intrinsicParameter/charucoboardCalibration/test_cam_calibration.py", "Python", 0, 44, 0, 1, 8, 53
"/home/wenzihao/Desktop/WandCalibration/intrinsicParameter/checkerboardCalibration/get_cam_calibration.py", "Python", 0, 43, 0, 6, 1, 50
"/home/wenzihao/Desktop/WandCalibration/intrinsicParameter/checkerboardCalibration/test_cam_calibration.py", "Python", 0, 49, 0, 14, 18, 81
"/home/wenzihao/Desktop/WandCalibration/intrinsicParameter/intrinsicCalibration/get_intrinsic.py", "Python", 0, 66, 0, 10, 5, 81
"/home/wenzihao/Desktop/WandCalibration/main.py", "Python", 0, 121, 0, 8, 7, 136
"/home/wenzihao/Desktop/WandCalibration/pyinstaller.md", "Markdown", 0, 0, 6, 0, 1, 7
"/home/wenzihao/Desktop/WandCalibration/utils/__init__.py", "Python", 0, 0, 0, 0, 1, 1
"/home/wenzihao/Desktop/WandCalibration/utils/imageConcat.py", "Python", 0, 36, 0, 3, 2, 41
"/home/wenzihao/Desktop/WandCalibration/utils/verifyAccuracy.py", "Python", 0, 48, 0, 0, 4, 52
"/home/wenzihao/Desktop/WandCalibration/utils/yamlLoader.py", "Python", 0, 58, 0, 8, 14, 80
"/home/wenzihao/Desktop/WandCalibration/visualize/visCameraParams.py", "Python", 0, 47, 0, 3, 3, 53
"/home/wenzihao/Desktop/WandCalibration/visualize/vis_pole_detection.py", "Python", 0, 53, 0, 1, 6, 60
"Total", "-", 140, 2486, 8, 387, 302, 3323