"filename", "language", "Python", "YAML", "pip requirements", "Markdown", "comment", "blank", "total"
"/home/wenzihao/Desktop/WandCalibration/README.md", "Markdown", 0, 0, 0, 32, 0, 1, 33
"/home/wenzihao/Desktop/WandCalibration/blender/test.py", "Python", 12, 0, 0, 0, 1, 10, 23
"/home/wenzihao/Desktop/WandCalibration/config/cfg_archery_outdoor.yaml", "YAML", 0, 25, 0, 0, 11, 13, 49
"/home/wenzihao/Desktop/WandCalibration/config/cfg_uni.yaml", "YAML", 0, 45, 0, 0, 14, 8, 67
"/home/wenzihao/Desktop/WandCalibration/config/cfg_wtt.yaml", "YAML", 0, 1, 0, 0, 0, 1, 2
"/home/wenzihao/Desktop/WandCalibration/config/cfg_wtt_red.yaml", "YAML", 0, 25, 0, 0, 11, 7, 43
"/home/wenzihao/Desktop/WandCalibration/config/pole/pole760_red.yaml", "YAML", 0, 4, 0, 0, 0, 0, 4
"/home/wenzihao/Desktop/WandCalibration/config/wand/wand_wtt_red.yaml", "YAML", 0, 10, 0, 0, 8, 4, 22
"/home/wenzihao/Desktop/WandCalibration/extrinsicParameter/poleDetection/blobDetection.py", "Python", 2, 0, 0, 0, 1, 0, 3
"/home/wenzihao/Desktop/WandCalibration/extrinsicParameter/poleDetection/maskGeneration.py", "Python", 12, 0, 0, 0, 0, 0, 12
"/home/wenzihao/Desktop/WandCalibration/extrinsicParameter/poleDetection/wandDetection.py", "Python", 49, 0, 0, 0, 2, 4, 55
"/home/wenzihao/Desktop/WandCalibration/extrinsicParameter/refinePose/boundleAdjustment.py", "Python", 6, 0, 0, 0, -31, 2, -23
"/home/wenzihao/Desktop/WandCalibration/extrinsicParameter/refinePose/refinePose.py", "Python", 175, 0, 0, 0, 6, 9, 190
"/home/wenzihao/Desktop/WandCalibration/extrinsicParameter/worldCoord/adjustCamParam.py", "Python", 16, 0, 0, 0, 0, 0, 16
"/home/wenzihao/Desktop/WandCalibration/extrinsicParameter/worldCoord/cluster.py", "Python", 40, 0, 0, 0, 4, 5, 49
"/home/wenzihao/Desktop/WandCalibration/extrinsicParameter/worldCoord/get_cam0_extrinsic.py", "Python", 53, 0, 0, 0, 1, 2, 56
"/home/wenzihao/Desktop/WandCalibration/extrinsicParameter/worldCoord/get_id_with_distance.py", "Python", 18, 0, 0, 0, 0, 1, 19
"/home/wenzihao/Desktop/WandCalibration/extrinsicParameter/worldCoord/noIdReconstruction.py", "Python", 8, 0, 0, 0, 10, 0, 18
"/home/wenzihao/Desktop/WandCalibration/extrinsicParameter/worldCoord/solve_icp.py", "Python", 3, 0, 0, 0, 0, 0, 3
"/home/wenzihao/Desktop/WandCalibration/intrinsicParameter/charucoboardCalibration/get_cam_calibration.py", "Python", 33, 0, 0, 0, 2, 0, 35
"/home/wenzihao/Desktop/WandCalibration/intrinsicParameter/checkerboardCalibration/get_cam_calibration.py", "Python", 34, 0, 0, 0, 1, 3, 38
"/home/wenzihao/Desktop/WandCalibration/intrinsicParameter/intrinsicCalibration/get_intrinsic.py", "Python", 0, 0, 0, 0, 0, 1, 1
"/home/wenzihao/Desktop/WandCalibration/main.py", "Python", 53, 0, 0, 0, -6, 0, 47
"/home/wenzihao/Desktop/WandCalibration/requirements.txt", "pip requirements", 0, 0, 11, 0, 0, 1, 12
"/home/wenzihao/Desktop/WandCalibration/utils/verifyAccuracy.py", "Python", 4, 0, 0, 0, 0, 2, 6
"/home/wenzihao/Desktop/WandCalibration/visualize/get_init_camera_params.py", "Python", 17, 0, 0, 0, 0, 3, 20
"/home/wenzihao/Desktop/WandCalibration/visualize/vis_pole_detection.py", "Python", 14, 0, 0, 0, 0, 2, 16
"/home/wenzihao/Desktop/WandCalibration/visualize/vis_reproj_error.py", "Python", 107, 0, 0, 0, 2, 11, 120
"Total", "-", 656, 110, 11, 32, 37, 90, 936