"filename", "language", "Python", "YAML", "Markdown", "pip requirements", "comment", "blank", "total"
"/home/wenzihao/Desktop/WandCalibration/README.md", "Markdown", 0, 0, 1, 0, 0, 0, 1
"/home/wenzihao/Desktop/WandCalibration/config/cfg_uni.yaml", "YAML", 0, 1, 0, 0, 4, 1, 6
"/home/wenzihao/Desktop/WandCalibration/extrinsicParameter/poleDetection/wandDetection.py", "Python", 4, 0, 0, 0, 3, 0, 7
"/home/wenzihao/Desktop/WandCalibration/extrinsicParameter/refinePose/refinePose.py", "Python", 6, 0, 0, 0, 0, 0, 6
"/home/wenzihao/Desktop/WandCalibration/extrinsicParameter/worldCoord/get_cam0_extrinsic.py", "Python", 2, 0, 0, 0, 0, 0, 2
"/home/wenzihao/Desktop/WandCalibration/main.py", "Python", 4, 0, 0, 0, 0, 0, 4
"/home/wenzihao/Desktop/WandCalibration/requirements.txt", "pip requirements", 0, 0, 0, 1, 0, 0, 1
"/home/wenzihao/Desktop/WandCalibration/visualize/visCameraParams.py", "Python", 44, 0, 0, 0, 11, 2, 57
"/home/wenzihao/Desktop/WandCalibration/visualize/vis_pole_spread.py", "Python", 6, 0, 0, 0, 0, 0, 6
"Total", "-", 66, 1, 1, 1, 18, 3, 90