"filename", "language", "Python", "YAML", "Markdown", "pip requirements", "comment", "blank", "total"
"/home/wenzihao/Desktop/WandCalibration/README.md", "Markdown", 0, 0, 3, 0, 0, 1, 4
"/home/wenzihao/Desktop/WandCalibration/config/cfg_uni.yaml", "YAML", 0, -4, 0, 0, 14, 1, 11
"/home/wenzihao/Desktop/WandCalibration/config/labelme/labelme_sample.yaml", "YAML", 0, 6, 0, 0, 2, 0, 8
"/home/wenzihao/Desktop/WandCalibration/extrinsicParameter/refinePose/multiViewTriangulate.py", "Python", 19, 0, 0, 0, 1, 1, 21
"/home/wenzihao/Desktop/WandCalibration/extrinsicParameter/worldCoord/adjustCamParam.py", "Python", 10, 0, 0, 0, 0, 0, 10
"/home/wenzihao/Desktop/WandCalibration/extrinsicParameter/worldCoord/get_cam0_extrinsic.py", "Python", 75, 0, 0, 0, 1, 1, 77
"/home/wenzihao/Desktop/WandCalibration/extrinsicParameter/worldCoord/handle_labelme.py", "Python", 131, 0, 0, 0, 1, 8, 140
"/home/wenzihao/Desktop/WandCalibration/main.py", "Python", 11, 0, 0, 0, 0, 0, 11
"/home/wenzihao/Desktop/WandCalibration/requirements.txt", "pip requirements", 0, 0, 0, 1, 0, 0, 1
"/home/wenzihao/Desktop/WandCalibration/visualize/visCameraParams.py", "Python", 1, 0, 0, 0, 0, 0, 1
"/home/wenzihao/Desktop/WandCalibration/visualize/vis_pole_spread.py", "Python", 64, 0, 0, 0, 0, 6, 70
"Total", "-", 311, 2, 3, 1, 19, 18, 354